0
17,16
4,6
1
0,0,0,0,0,1,1,1,0,0,0,0,0,0,0,0,0
0,0,0,1,1,1,0,1,1,1,1,1,1,1,0,0,0
0,0,0,1,1,1,6,7,1,1,1,1,1,1,0,0,0
0,0,0,1,1,1,2,1,1,1,1,1,1,1,0,0,0
0,0,0,1,1,1,0,1,1,1,1,1,1,1,0,0,0
0,0,0,1,0,5,5,4,1,1,1,1,1,1,0,0,0
0,0,0,1,0,1,1,1,1,1,0,1,1,1,0,0,0
0,0,0,1,0,0,0,4,0,2,6,0,1,1,0,0,0
0,0,0,1,0,0,2,4,1,1,1,1,1,1,0,0,0
0,0,0,1,0,2,2,4,0,1,1,1,1,1,0,0,0
0,0,0,1,0,2,4,4,1,1,1,1,1,1,0,0,0
0,0,0,1,1,1,0,1,1,1,1,1,1,1,0,0,0
0,0,0,1,1,1,1,1,1,1,1,1,1,1,0,0,0
0,0,0,1,1,1,1,1,1,1,1,1,1,1,0,0,0
0,0,0,1,1,1,1,1,1,1,1,1,1,1,0,0,0
0,0,0,0,0,0,0,0,0,0,0,0,0,0,0,0,0
5
0:4,7
0:6,4
0:8,9
0:6,11
2:10,6
0
