0
13,9
4,2
0,0,0,0,0,0,0,0,0,0,0,0,0
0,0,0,1,1,1,1,1,1,0,0,0,0
0,0,0,1,0,0,0,0,1,0,0,0,0
0,0,0,1,1,1,0,1,1,0,0,0,0
0,0,0,0,0,1,7,1,0,0,0,0,0
0,0,0,0,0,1,1,1,0,0,0,0,0
0,0,0,0,0,0,0,0,0,0,0,0,0
0,0,0,0,0,0,0,0,0,0,0,0,0
0,0,0,0,0,0,0,0,0,0,0,0,0
1
0:7,2
