100
13,12
1,3
1,1,1,1,1,1,1,1,1,1,1,1,1
1,1,1,1,1,1,1,1,1,1,1,1,1
1,1,1,1,1,1,1,1,1,1,0,1,1
1,0,5,0,1,1,1,1,1,1,5,1,1
1,5,1,5,1,1,1,1,1,1,5,1,1
1,0,5,5,5,5,5,0,5,5,4,1,1
1,1,1,5,1,1,1,5,1,1,2,1,1
1,1,1,5,1,1,1,5,1,1,5,1,1
1,1,1,5,1,1,1,5,1,1,5,1,1
1,1,1,0,1,1,1,0,5,5,0,1,1
1,1,1,1,1,1,1,7,1,1,1,1,1
1,1,1,1,1,1,1,1,1,1,1,1,1
2
0:3,9
0:10,2
