100
13,12
5,3
0,0,0,0,0,0,0,0,0,0,0,0,0
0,0,0,0,0,0,0,0,0,0,0,0,0
0,0,0,0,1,1,1,1,1,0,0,0,0
0,0,0,0,1,0,0,0,1,1,0,0,0
0,0,0,0,1,0,2,0,0,1,0,0,0
0,0,0,1,1,1,2,1,1,1,0,0,0
0,0,0,1,0,0,0,1,0,0,0,0,0
0,0,0,1,0,1,0,1,1,1,0,0,0
0,0,0,1,0,0,0,0,7,1,0,0,0
0,0,0,1,1,1,1,1,1,1,0,0,0
0,0,0,0,0,0,0,0,0,0,0,0,0
0,0,0,0,0,0,0,0,0,0,0,0,0
2
0:8,4
0:6,8
